{
  "cells": {
    "5_20": 30,
    "0_12": 48,
    "3_10": 18,
    "4_1": 3,
    "3_25": 40,
    "4_11": 50,
    "4_15": 51,
    "4_5": 9,
    "1_14": 45,
    "3_16": 27,
    "3_14": 23,
    "5_10": 14,
    "0_15": 49,
    "3_0": 4,
    "5_26": 37,
    "1_11": 42,
    "1_12": 43,
    "3_8": 16,
    "5_2": 2,
    "3_1": 5,
    "1_15": 46,
    "3_4": 10,
    "4_7": 52,
    "5_6": 8,
    "1_13": 44,
    "4_19": 53,
    "5_24": 36,
    "5_8": 13,
    "4_21": 32,
    "5_14": 20,
    "3_22": 35,
    "3_12": 22,
    "3_18": 29,
    "4_17": 26,
    "3_26": 41,
    "3_9": 17,
    "3_21": 34,
    "5_22": 31,
    "3_6": 12,
    "5_4": 7,
    "5_12": 19,
    "3_24": 39,
    "3_5": 11,
    "5_18": 25,
    "3_20": 33,
    "4_9": 15,
    "3_17": 28,
    "1_16": 47,
    "3_2": 6,
    "5_0": 1,
    "4_13": 21,
    "5_16": 24,
    "4_25": 38
  }
}